####################################################################################
# C 1      #                                                                       #
#          #               #####                                                   #
#                                                              #######             #
############                                                   #     #             #
#                                  ####                        #     #             #
#                      #####       ######                      ##   ##             #
#                 ###########              ###                                     #
#      ##                                   ###                                    #
#      ##                                         ##############                   #
#      ##          #####                          #      #     #                   #
#      ##              #####                                   #                   #
#                                           	               #                   #
#                 #                 #####         #      #     #                   #
####################################################################################